sdu -> sodu
postpowania -> postepowania
moe -> me
take -> takle
najwyszy -> namywszy
zwizku -> zwitku
naley -> nalec
przepisw -> przepisy
ktre -> kare
sygn -> syga
najwyszego -> najsytszego
sposb -> sporo
okrgowy -> krowy
rwnie -> rynie
postpowaniu -> postepowaniu
nieruchomoci -> nieruchomi
padziernika -> papiernika
zosta -> tosta
zostaa -> zostaw
byo -> boy
ktry -> itry
treci -> troci
span -> spak
ktrych -> karych
powd -> pow
ktrym -> trym
ktrej -> karej
okrgowego -> okopowego
skarcy -> skarpy
ssn -> san